house1_room4 17
11 12
3
1 add_more
513 room-01-udw3
697 room-01-udx
4
0 0 0 0 0 0 0 0 0 0 0
0 0 0 0 0 0 0 0 0 0 0
312 312 312 312 312 312 312 312 312 312 312
312 312 312 312 312 312 312 312 312 312 312
312 312 312 312 312 312 312 312 312 312 312
312 312 312 312 312 0 0 312 312 312 312
312 312 312 312 312 0 0 312 312 312 312
312 312 312 312 312 312 312 312 312 312 312
312 312 312 312 312 312 312 312 312 312 312
312 312 312 312 312 312 312 312 312 312 312
312 312 312 312 312 312 312 312 312 312 312
0 0 0 0 0 0 0 0 0 0 0

701 701 701 701 701 701 701 701 701 701 701
701 701 701 701 701 701 701 701 701 701 701
513 514 515 516 513 514 515 516 513 514 515
513 514 515 516 513 514 515 516 513 514 515
513 514 515 516 513 514 515 516 513 514 515
513 514 515 516 513 514 515 516 513 514 515
513 514 515 516 513 514 515 516 513 514 515
513 514 515 516 513 514 515 516 513 514 515
513 514 515 516 513 514 515 516 513 514 515
513 514 515 516 513 514 515 516 513 514 515
513 514 515 516 513 514 515 516 513 514 515
28 28 28 28 28 514 28 28 28 28 28

521 521 521 521 521 521 521 521 521 521 521
529 529 529 529 529 529 529 529 529 529 529
0 0 0 0 0 0 0 0 0 0 0
0 0 0 0 0 0 0 0 0 0 0
0 0 0 0 0 0 0 0 0 0 0
0 0 0 0 0 0 0 0 0 0 0
0 0 0 0 0 0 0 0 0 0 0
0 0 0 0 0 0 0 0 0 0 0
0 0 0 0 0 0 0 0 0 0 0
0 0 0 0 0 0 0 0 0 0 0
0 0 0 0 0 0 0 0 0 0 0
0 0 0 0 0 0 0 0 0 0 0

0 0 0 0 0 0 0 0 0 591 1792
1802 1803 0 0 0 0 0 0 0 591 1800
1810 1811 0 0 0 0 0 0 0 591 1808
0 0 0 0 0 0 0 0 0 0 0
0 0 0 0 0 0 0 0 0 0 0
0 0 0 0 0 1605 1606 0 0 0 0
0 0 0 0 0 1613 1614 0 0 0 0
0 0 0 0 0 0 0 0 0 0 0
0 0 0 0 0 0 0 0 0 0 0
0 0 0 0 0 0 0 0 0 0 0
0 0 0 0 0 0 0 0 0 0 0
0 0 0 0 0 0 0 0 0 0 0

