house1_room2 15
9 12
3
1 add_more
513 room-01-udy
929 room-01-udx
5
0 0 0 0 0 0 0 0 0
0 0 0 0 0 0 0 0 0
312 312 312 312 312 312 312 312 312
312 312 312 312 312 312 312 312 312
312 312 312 312 312 312 312 312 312
312 312 312 312 312 312 312 312 312
312 312 312 312 312 312 312 312 312
312 312 312 312 312 312 312 312 312
312 312 312 312 312 312 312 312 312
312 312 312 312 312 312 312 312 312
312 312 312 312 312 312 312 0 0
0 0 0 0 0 0 0 0 0

30 30 30 30 30 30 30 30 30
30 30 30 30 30 30 30 30 30
513 514 515 516 513 514 515 516 513
513 514 515 516 513 514 515 516 513
513 514 515 516 513 514 515 516 513
513 514 515 516 513 514 515 516 513
513 514 515 516 513 514 515 516 513
513 514 515 516 513 514 515 516 513
513 514 515 516 513 514 515 516 513
513 514 515 516 513 514 515 516 513
513 514 515 516 513 514 515 516 513
28 28 28 28 513 28 28 28 28

521 521 521 521 521 521 521 521 521
529 529 529 529 529 529 529 529 529
0 0 0 0 0 0 0 0 0
0 0 0 0 0 0 0 0 0
0 0 0 0 0 0 0 0 0
0 0 0 0 0 0 0 0 0
0 0 0 0 0 0 0 0 0
0 0 0 0 0 0 0 0 0
0 0 0 0 0 0 0 0 0
0 0 0 0 0 0 0 0 0
0 0 0 0 0 0 0 0 0
0 0 0 0 0 0 0 0 0

0 0 0 0 0 0 0 0 0
0 0 0 0 0 0 0 2130 2131
0 0 0 0 0 0 0 2138 2139
0 0 0 0 0 0 0 0 0
0 0 0 0 0 0 0 0 0
0 0 0 0 0 0 0 0 0
0 0 0 0 0 0 0 0 0
0 0 0 0 0 0 0 0 0
0 0 0 0 0 0 0 0 0
0 0 0 0 0 0 0 0 0
0 0 0 0 0 0 0 1795 2140
0 0 0 0 0 0 0 0 0

0 0 0 0 0 0 0 0 0
0 0 0 0 0 0 0 0 0
0 0 0 0 0 0 0 0 0
0 0 0 0 0 0 0 0 0
0 0 0 0 0 0 0 0 0
0 0 0 0 0 0 0 0 0
0 0 0 0 0 0 0 0 0
0 0 0 0 0 0 0 0 0
0 0 0 0 0 0 0 0 0
0 0 0 0 0 0 0 1787 2132
0 0 0 0 0 0 0 0 0
0 0 0 0 0 0 0 0 0

