house1_basement4 3
9 10
2
1 add_more
513 room-01-udz
5
0 0 0 0 0 0 0 0 0
0 0 0 0 0 0 0 0 0
0 312 312 312 312 312 312 312 312
0 312 312 312 312 0 312 312 312
0 312 312 312 312 312 312 312 312
0 0 0 0 0 0 312 312 0
0 312 312 312 312 312 312 312 312
0 312 312 312 312 312 312 312 312
0 312 312 312 312 312 312 312 312
0 312 312 312 312 312 312 312 312

28 43 43 43 43 43 43 43 43
28 43 43 43 43 43 43 43 43
28 77 77 77 77 77 77 77 77
28 77 77 77 77 77 77 77 77
28 77 77 77 77 77 77 77 77
28 77 77 77 77 77 77 77 77
43 77 77 77 77 77 77 77 77
43 77 77 77 77 77 77 77 77
77 77 77 77 77 77 77 77 77
28 77 77 77 77 77 77 77 77

0 11 11 11 11 11 11 11 11
0 27 27 27 27 27 27 27 27
0 0 0 0 0 0 0 0 0
0 0 0 0 0 0 0 0 0
0 0 0 0 0 0 0 0 0
0 0 0 0 0 0 0 0 0
11 0 0 0 0 0 0 0 0
27 0 0 0 0 0 0 0 0
0 0 0 0 0 0 0 0 0
0 0 0 0 0 0 0 0 0

0 109 110 0 0 0 0 0 0
0 125 126 0 0 0 0 0 0
0 0 0 0 0 0 0 0 0
0 0 0 0 0 86 0 0 0
0 0 0 0 0 0 0 0 0
0 617 618 618 618 618 0 0 619
0 0 0 0 0 0 0 0 0
0 0 0 0 0 0 0 0 0
0 0 0 0 0 0 0 0 0
0 0 0 0 0 0 0 0 0

0 0 0 0 0 0 0 0 0
0 0 0 0 0 0 0 0 0
0 0 0 0 0 70 0 0 0
0 0 0 0 0 0 0 0 0
0 609 610 610 610 610 0 0 611
0 0 0 0 0 0 0 0 0
0 0 0 0 0 0 0 0 0
0 0 0 0 0 0 0 0 0
0 0 0 0 0 0 0 0 0
0 0 0 0 0 0 0 0 0

