house2_lobby 36
13 11
1
1 add_more
4
0 0 0 0 0 0 0 0 0 0 0 0 0
0 0 0 0 0 0 312 312 312 0 0 0 0
0 0 0 0 0 0 312 312 312 0 0 0 0
0 0 0 0 0 0 312 312 312 0 0 0 0
0 0 0 312 312 0 312 312 312 0 0 0 0
0 312 312 312 312 312 312 312 312 312 312 312 0
0 312 312 312 312 312 312 312 312 312 312 312 0
0 312 312 312 312 312 312 312 312 312 312 312 0
0 312 312 312 312 312 312 312 312 312 312 312 0
0 312 312 312 312 312 312 312 312 312 312 0 0
0 0 0 0 0 0 0 0 0 0 0 0 0

28 28 28 28 28 28 119 120 119 28 28 28 28
28 28 28 28 28 28 119 120 119 28 28 28 28
28 28 28 28 28 28 119 137 119 28 28 28 28
28 153 153 28 28 153 119 120 119 153 153 153 153
153 153 153 120 119 153 119 120 138 153 153 153 153
153 120 119 120 119 120 119 120 119 122 119 120 119
119 120 119 120 119 106 119 120 119 120 119 120 28
28 120 119 120 119 120 119 120 119 120 119 120 28
28 120 119 120 119 120 119 120 119 120 119 120 28
28 154 119 120 119 120 119 120 119 120 119 121 28
28 28 28 28 28 28 119 28 28 28 28 28 28

0 0 0 0 0 0 0 0 0 0 0 0 0
0 0 0 0 0 0 0 0 0 0 0 0 0
0 0 0 0 0 0 0 0 0 0 0 0 0
0 135 135 0 0 135 0 0 0 135 135 135 135
135 151 151 0 0 151 0 0 0 151 151 151 151
151 0 0 0 0 0 0 0 0 0 0 0 0
0 0 0 0 0 0 0 0 0 0 0 0 0
0 0 0 0 0 0 0 0 0 0 0 0 0
0 0 0 0 0 0 0 0 0 0 0 0 0
0 0 0 0 0 0 0 0 0 0 0 0 0
0 0 0 0 0 0 0 0 0 0 0 0 0

0 0 0 136 136 0 0 0 0 0 0 0 0
0 0 0 136 136 0 0 0 0 0 0 0 0
0 0 0 136 136 0 0 0 0 0 0 0 0
0 0 0 136 136 0 0 0 0 0 0 0 0
0 0 0 152 152 0 0 0 0 0 0 0 0
0 0 0 0 0 0 0 0 0 0 0 0 0
0 0 0 0 0 0 0 0 0 0 0 0 0
0 0 0 0 0 0 0 0 0 0 0 0 0
0 0 0 0 0 0 0 0 0 0 0 0 0
0 0 0 0 0 0 0 0 0 0 0 0 0
0 0 0 0 0 0 0 0 0 0 0 0 0

