house2_room6 42
12 11
1
1 add_more
5
0 0 0 0 0 0 0 0 0 0 0 0
0 0 0 0 0 0 0 0 0 0 0 0
312 312 312 312 312 312 312 312 312 312 312 312
312 312 312 312 312 312 312 312 312 312 312 312
312 312 312 312 312 312 312 312 312 312 312 312
312 312 312 312 312 312 312 312 312 312 0 0
312 312 312 312 312 312 312 312 312 312 0 0
312 312 312 312 312 312 312 312 312 312 0 0
312 312 312 312 312 312 312 312 312 312 0 0
0 312 312 312 312 312 312 312 312 312 0 0
0 0 0 0 0 0 0 0 0 0 0 0

153 153 153 153 153 153 153 153 153 153 153 153
153 153 153 153 153 153 153 153 153 153 153 153
119 122 119 120 141 120 119 120 119 120 119 102
119 120 119 120 119 120 119 120 119 120 119 120
119 120 119 120 119 120 119 120 119 120 119 120
119 120 138 120 119 120 119 106 119 120 28 28
154 120 119 120 119 120 119 120 119 169 28 28
119 120 119 120 119 120 119 120 119 120 28 28
119 120 119 120 119 120 119 120 119 120 28 28
103 120 119 120 137 120 119 120 122 120 28 28
28 28 119 28 28 28 28 28 28 120 28 28

0 0 0 0 0 0 0 0 0 0 0 0
0 0 0 0 0 0 0 0 0 0 0 0
0 0 0 0 0 0 0 0 0 0 0 0
0 0 0 0 0 0 0 0 0 0 0 0
0 0 0 0 0 0 0 0 0 0 0 0
0 0 0 0 0 0 0 0 0 0 0 0
0 0 0 0 0 0 0 0 0 0 0 0
0 0 0 0 0 0 0 0 0 0 0 0
0 0 0 0 0 0 0 0 0 0 0 0
0 0 0 0 0 0 0 0 0 0 0 0
0 0 0 0 0 0 0 0 0 0 0 0

0 0 0 0 0 0 0 0 0 0 0 0
0 0 0 0 0 0 0 0 0 0 0 0
0 0 0 0 0 0 0 0 0 0 0 0
0 0 0 0 0 0 0 0 0 0 0 0
0 0 0 0 0 0 0 0 0 0 0 0
0 0 0 0 0 0 0 0 0 0 136 136
0 0 0 0 0 0 0 0 0 0 136 136
0 0 0 0 0 0 0 0 0 0 136 136
0 0 0 0 0 0 0 0 0 0 136 136
0 0 0 0 0 0 0 0 0 0 152 152
0 0 0 0 0 0 0 0 0 0 0 0

0 0 0 0 0 0 0 0 0 0 0 0
0 0 0 0 0 0 0 0 0 0 0 0
0 0 0 0 0 0 0 0 0 0 0 0
0 0 0 0 0 0 0 0 0 0 0 0
0 0 0 0 0 0 0 0 0 0 104 0
0 0 0 0 0 0 0 0 0 0 105 0
0 0 0 0 0 0 0 0 0 0 105 0
0 0 0 0 0 0 0 0 0 0 105 0
0 0 0 0 0 0 0 0 0 0 105 0
0 0 0 0 0 0 0 0 0 0 105 0
0 0 0 0 0 0 0 0 0 0 0 0

