house3_room1 49
11 10
3
1 room-01-udw
1113 room-01-ud
1481 room-01-udx
3
0 1033 1034 1035 1036 1037 1038 1039 1040 1033 1034
0 1041 1042 1043 1044 1045 1046 1047 1048 1041 1042
0 1 2 3 4 1 2 3 4 1 2
0 1 2 3 4 1 2 3 4 1 2
1060 1 2 3 4 1 2 3 4 1 2
1068 1 2 3 4 1 2 3 4 1 2
1 1 2 3 4 1 2 3 4 1 2
0 1 2 3 4 1 2 3 4 1 2
0 1 2 3 4 1 2 3 4 1 2
0 1 2 3 4 1 2 3 4 1 2

0 671 672 0 0 0 0 0 0 0 0
0 679 680 954 0 0 0 0 0 0 0
0 687 688 961 0 0 0 0 0 0 0
0 0 0 0 0 0 0 0 0 0 0
0 0 0 0 0 0 0 0 0 0 0
0 0 0 0 0 0 0 0 0 0 0
0 0 0 0 0 0 0 0 0 0 0
0 1795 1796 0 0 0 0 0 0 0 0
0 1803 1804 0 0 0 0 0 0 0 0
0 1797 1798 0 0 0 0 0 0 0 0

0 0 0 0 0 0 0 0 0 0 0
0 0 0 0 0 0 0 0 0 0 0
0 0 0 0 0 0 0 0 0 0 0
0 0 0 0 0 0 0 0 0 0 0
0 0 0 0 0 0 0 0 0 0 0
0 0 0 0 0 0 0 0 0 0 0
0 0 0 0 0 0 0 0 0 0 0
0 0 0 0 0 0 0 0 0 0 0
0 0 0 0 0 0 0 0 0 0 0
0 1807 1808 0 0 0 0 0 0 0 0

