house3_room3 51
9 12
1
1 room-01-udw
2
1033 1034 1035 1036 1037 1038 1039 1040 1033
1041 1042 1043 1044 1045 1046 1047 1048 1041
1049 1050 1051 1052 1053 1054 1055 1056 1049
1 2 3 4 1 2 3 4 1
1 2 3 4 1 2 3 4 1
1 2 0 0 0 0 0 4 1
1 2 0 0 0 0 0 4 1
1 2 0 0 0 0 0 4 1
1 1 0 0 0 0 0 4 1
1 2 3 4 1 1 2 4 4
1 2 3 4 1 1 2 3 4
0 0 0 0 3 0 0 0 0

0 0 0 0 0 0 0 0 0
672 669 0 0 0 0 0 0 0
680 677 0 0 0 0 0 0 0
688 685 0 0 0 0 0 0 0
0 0 0 0 0 0 0 0 0
0 0 0 0 0 0 0 0 0
0 0 0 0 0 0 0 0 0
0 0 0 0 0 0 0 0 0
0 0 0 0 0 0 0 0 0
0 0 0 0 0 0 463 477 478
0 0 0 0 0 0 471 485 486
0 0 0 0 0 0 0 0 0

