house3_hallway1 54
20 17
2
1 room-01-udw
1113 add_more
4
0 0 0 0 0 0 0 0 0 0 0 0 0 0 0 0 0 0 0 0
0 0 0 0 0 0 0 0 0 0 0 0 0 0 0 0 0 0 0 0
0 0 0 0 0 0 0 0 0 0 0 0 0 0 0 0 0 0 0 0
0 0 1424 1424 1424 0 0 0 0 0 0 0 0 0 0 0 0 0 0 0
0 0 1424 1424 1424 0 0 0 0 0 0 0 0 0 0 0 0 0 0 0
0 0 1424 1424 1424 0 0 0 0 0 0 0 0 0 0 0 0 0 0 0
0 0 1424 1424 1424 1424 0 0 0 0 0 0 0 0 0 0 0 0 0 0
0 0 1424 1424 1424 0 0 0 0 0 0 0 0 0 0 0 0 0 0 0
0 0 1424 1424 1424 0 0 0 0 0 0 0 0 0 0 0 0 0 0 0
0 0 1424 1424 1424 0 0 0 0 0 0 0 0 0 0 0 0 0 0 0
0 0 1424 1424 1424 0 0 0 0 0 0 0 0 0 0 0 0 0 0 0
0 0 1424 1424 1424 0 0 0 0 0 0 0 0 0 0 0 0 0 0 0
0 0 1424 1424 1424 0 0 0 0 0 0 0 0 0 0 0 0 0 0 0
1424 1424 1424 1424 1424 0 0 0 0 0 0 0 0 0 0 0 0 0 0 0
1424 1424 1424 1424 1424 1424 1424 1424 1424 1424 1424 1424 1424 1424 1424 1424 1424 1424 1424 1424
1424 1424 1424 1424 1424 1424 1424 1424 1424 1424 1424 1424 1424 1424 1424 1424 1424 1424 1424 0
1424 1424 1424 1424 1424 1424 1424 1424 1424 1424 1424 1424 1424 1424 1424 1424 1424 1424 1424 1424

0 0 1035 1036 1037 0 0 0 0 0 0 0 0 0 0 0 0 0 0 0
0 0 1043 1044 1045 0 0 0 0 0 0 0 0 0 0 0 0 0 0 0
0 0 1051 1052 1053 0 0 0 0 0 0 0 0 0 0 0 0 0 0 0
0 0 1 2 3 1033 0 0 0 0 0 0 0 0 0 0 0 0 0 0
0 0 1 2 3 1041 0 0 0 0 0 0 0 0 0 0 0 0 0 0
0 0 1 2 3 1049 0 0 0 0 0 0 0 0 0 0 0 0 0 0
0 0 1 2 3 4 0 0 0 0 0 0 0 0 0 0 0 0 0 0
0 0 1 2 3 0 0 0 0 0 0 0 0 0 0 0 0 0 0 0
57 57 1 2 3 0 0 0 0 0 0 0 0 0 0 0 0 0 0 0
57 57 1 2 3 0 0 0 0 0 0 0 0 0 0 0 0 0 0 0
57 57 1 2 3 0 0 0 0 0 0 0 0 0 0 0 0 0 0 0
57 57 1 2 3 1033 1034 1035 1036 1037 1038 1039 1040 1057 1058 1059 1060 1061 1062 1063
57 57 1 2 3 1041 1042 1043 1044 1045 1046 1047 1048 1065 1066 1067 1068 1069 1070 1071
3 4 1 2 3 1049 1050 1051 1052 1053 1054 1055 1056 1073 1074 1075 1076 1077 1078 1079
1 2 3 4 3 1 2 3 4 1 2 3 4 1 2 3 4 1 2 3
1 2 3 4 3 1 2 3 4 1 2 3 4 1 2 3 4 1 118 119
1 2 3 4 3 1 2 3 4 1 2 3 4 1 2 3 4 1 2 3

0 0 0 0 0 0 0 0 0 0 0 0 0 0 0 0 0 0 0 0
0 0 0 1121 0 0 0 0 0 0 0 0 0 0 0 0 0 0 0 0
0 0 0 1137 0 0 0 0 0 0 0 0 0 0 0 0 0 0 0 0
0 0 0 0 0 0 0 0 0 0 0 0 0 0 0 0 0 0 0 0
0 0 0 0 0 0 0 0 0 0 0 0 0 0 0 0 0 0 0 0
0 0 0 0 0 0 0 0 0 0 0 0 0 0 0 0 0 0 0 0
0 0 0 0 0 0 0 0 0 0 0 0 0 0 0 0 0 0 0 0
0 0 0 0 0 0 0 0 0 0 0 0 0 0 0 0 0 0 0 0
57 57 0 0 0 0 0 0 0 0 0 0 0 0 0 0 0 0 0 0
57 57 0 0 0 0 0 0 0 0 0 0 0 0 0 0 0 0 0 0
57 57 0 0 0 0 0 0 0 0 0 0 0 0 0 0 0 0 0 0
57 57 0 0 0 0 0 0 0 0 0 0 0 0 0 0 0 0 0 0
57 57 0 0 0 0 1121 0 0 0 0 0 0 1425 0 0 0 0 0 0
65 65 0 0 0 0 1137 0 0 0 0 0 0 1441 0 0 0 0 0 0
0 0 0 0 0 0 0 0 0 0 0 0 0 0 0 0 0 0 0 0
0 0 0 0 0 0 0 0 0 0 0 0 0 0 0 0 0 0 0 0
0 0 0 0 0 0 0 0 0 0 0 0 0 0 0 0 0 0 0 0

0 0 0 0 0 0 0 0 0 0 0 0 0 0 0 0 0 0 0 0
0 0 0 0 0 0 0 0 0 0 0 0 0 0 0 0 0 0 0 0
0 0 0 0 0 0 0 0 0 0 0 0 0 0 0 0 0 0 0 0
0 0 0 0 0 0 0 0 0 0 0 0 0 0 0 0 0 0 0 0
0 0 0 0 0 0 0 0 0 0 0 0 0 0 0 0 0 0 0 0
0 0 0 0 0 0 0 0 0 0 0 0 0 0 0 0 0 0 0 0
0 0 0 0 0 0 0 0 0 0 0 0 0 0 0 0 0 0 0 0
0 0 0 0 0 0 0 0 0 0 0 0 0 0 0 0 0 0 0 0
0 47 0 0 0 0 0 0 0 0 0 0 0 0 0 0 0 0 0 0
0 47 0 0 0 0 0 0 0 0 0 0 0 0 0 0 0 0 0 0
0 47 0 0 0 0 0 0 0 0 0 0 0 0 0 0 0 0 0 0
0 47 0 0 0 0 0 0 0 0 0 0 0 0 0 0 0 0 0 0
0 47 0 0 0 0 0 0 0 0 0 0 0 0 0 0 0 0 0 0
0 63 0 0 0 0 0 0 0 0 0 0 0 0 0 0 0 0 0 0
0 0 0 0 0 0 0 0 0 0 0 0 0 0 0 0 0 0 0 0
0 0 0 0 0 0 0 0 0 0 0 0 0 0 0 0 0 0 0 0
0 0 0 0 0 0 0 0 0 0 0 0 0 0 0 0 0 0 0 0

